WWWWWWWWWW
WXXXXXXXXW
WXBBBWBWPW
WXTTXTXTXW
WXWWWBBBXW
WXWTTXTWXW
WXXXXXXXXW
WWWWWWWWWW